10000110
00000000
10001110
10000101
10001000
10000110
00000000
10001110
10001000
10001110
10000111
10000101
00000000
00000000
00000000
00000000
00000000
00000000
00000000
00000000
00000000
01111111
00000000
00000000
00000000
00000000
00000000
00000000
00000000
00000000
00000000
00000000
00000000
00000000
00000000
00000000
00000000
00000000
00000000
00000000
00000000
00000000
00000000
00000000
00000000
00000000
00000000
00000000
00000000
00000000
10001110
00000000
00000000
10000100
00000000
10001110
00000000
10000110
00000000
00000000
10001101
00000000
00000000
00000000
00000000
00000000
00000000
00000000
00000000
00000000
00000000
00000000
00000000
00000000
00000000
00000000
00000000
00000000
00000000
00000000
00000000
00000000
00000000
00000000
00000000
00000000
00000000
00000000
00000000
00000000
00000000
00000000
00000000
00000000
00000000
00000000
