10010000
10110000
10010000
11000001
11111100
10010001
00000000
11010000
10100000
00000000
11001100
10010000
00000000
00000000
00000000
00000000
00000000
10001010
00000000
00000000
00000000
00000000
00000000
00000000
00000000
10001001
00000000
00000000
00000000
00000000
00000000
00000000
00000000
00000000
00000000
00000000
00000000
00000000
00000000
10010010
00000000
00000000
00000000
00000000
00000000
00000000
00000000
00000000
00000000
00000000
00000000
10011000
00000000
00000000
00000000
10010000
10010000
10011100
10010000
00000000
10010001
00000000
00000000
00000000
00000000
00000000
00000000
00000000
00000000
00000000
00000000
00000000
00000000
00000000
00000000
00000000
00000000
10001010
00000000
00000000
00000000
00000000
00000000
00000000
00000000
00000000
00000000
00000000
00000000
00000000
00000000
00000000
00000000
00000000
00000000
00000000
00000000
00000000
00000000
00000000
00000000
00000000
